# From Covington, 1997. "An algorithm to align words for historical comparison", Computational Linguistics
#
# (using Americanist symbols, as Covington does)
# Spanish <=>  French cognates (tables 3 & 4)
yo	žə	# yo:je	'I'
tu	tü	# tu:tu	'you'
nosotros	nu	# nosotros:nous	'we'
kyen	ki	# quién:qui	'who?'
ke	kwa	# qué:quoi	'what?'
todos	tu	# todos:tous	'all'
una	ün	# una:une	'one (f sg)'
dos	dö	# dos:deux	'two'
tres	trwa	# tres:troix	'three'
ombre	om	# hombre:homme	'man'
arbol	arbrə	# árbol:arbre	'tree'
pluma	plüm	# pluma:plume	'feather'
kabeθa	kap	# cabeza:cap	'head/promontory'
boka	buš	# boca:bouche	'mouth'
pye	pye	# pie:pied	'foot'
koraθon	kör	# corazón:coeur	'heart'
ber	vwar	# ver:voir	'see'
benir	vənir	# venir:venir	'come'
deθir	dir	# decir:dire	'say'
pobre	povrə	# pobre:pauvre	'poor'
# English <=> German cognates (tables 5 & 6)
ðis	dīzəs	# this:dieses	'this' #  sic the odd transcription of the vowel in 'this'...
ðæt	das	# that:das	'that'
# note w in "what" should really be w̥at
wat	vas	# what:vas	'what'
nat	nixt	# not:nicht	'not'
loŋ	laŋ	# long:lang	'long'
mæn	man	# man:Mann	'man'
fleš	flayš	# flesch:Fleisch	'flesh'
bləd	blūt	# blood:Blut	'blood'
feðər	fēdər	# feather:Feder	'feather'
hær	hār	# hair:Haar	'hair'
ir	ōr	# ear:Ohr	'ear'
ay	awgə	# eye:Auge	'eye'
nowz	nāzə	# nose:Nase	'nose'
mawθ	munt	# mouth:Munt	'mouth'
təŋ	tsuŋə	# tongue:Zunge	'tongue'
fut	fūs	# foot:Fuß	'foot'
niy	knī	# knee:Knie	'knee'
hænd	hant	# hand:Hand	'hand'
hart	herts	# heart:Herz	'heart'
livər	lēbər	# liver:Leber	'liver'
# English <=> Latin cognate pairs (Tables 7 & 8)
ænd	ante	# and:ante    'and'
æt	ad	# at:ad	      'at'
blow	flāre	# blow:flāre 	'blow'
ir	awris	# ear:auris	'ear'
iyt	edere	# eat:edere	'eat'
fiš	piskis	# fish:piscis	'fish'
flow	fluere	# flow:fluere	'flow'
star	stēlla	# star:stēlla	'star'
ful	plēnus	# full:plēnus	'full'
græs	grāmen	# grass:grāmen	'grass'
hart	kordis	# heart:cordis	'heart':'heart (gen.)'
horn	kornū	# horn:cornū	'horn'
ay	ego	# I:ego	'I'
niy	genū	# knee:genū	'knee'
məðər	māter	# mother:māter	'mother'
mawntən	mōns	# mountain:mōns	'mountain'
neym	nōmen	# name:nōmen	'name'
nyuw	nowus	# new:novus	'new'
wən	ūnus	# one:ūnus	'one'
rawnd	rotundus	# round:rotundus	'round'
sow	suere	# sew:suere	'sew'
sit	sēdere	# sit:sēdere	'sit'
θriy	trēs	# three:trēs	'three'
tuwθ	dentis	# tooth:dentis	'tooth':'tooth (gen.)'
θin	tenuis	# thin:tenuis	'thin'
# Fox <=> Menomini cognate pairs (Table 9)
kīnwāwa	kenuaq	# kiinwaawa:kenuaq	'you (pl.)'
nīna	nenah	# niina:nenah	'I'
#nāpēwa	nāpɛ̄w	# naapeewa:napɛɛw	'man'
nāpēwa	nāpɛw	# naapeewa:napɛɛw	'man'
wāpimini	wāpemen	# waapimini:waapemen	'maize'
#namēsa	namɛ̄qs	# nameesa:namɛqs	'fish (n.)'
namēsa	namɛqs	# nameesa:namɛqs	'fish (n.)'
okimāwa	okēmāw	# okimaawa:okeemaaw	'chief'
šīšīpa	sēqsep	# šiišiipa:seeqsep	'duck (n.)'
#ahkokwa	ahkɛ̄h	# ahkohkwa:ahkɛɛh	'kettle'
ahkokwa	ahkɛh	# ahkohkwa:ahkɛɛh	'kettle'
pemātesiweni	pemātesewen	# pemaatesiweni:pemaatesewen 'life'
asenya	aqsɛn	# asenya:aqsɛn	'stone (n.)'
# Other cognate pairs (Table 10)
didōmi	dō	# Greek didōmi:Latin dō	'I give'
#tʰugatēr	toxtər	# Greek tʰugatēr:German Tochter	'daughter'
thugatēr	toxtər	# Greek tʰugatēr:German Tochter	'daughter'
#dotər	tʰugatēr	# English daughter:Greek tʰugatēr	'daughter'
dotər	thugatēr	# English daughter:Greek tʰugatēr	'daughter'
#ager	aǰras	# Latin ager:Sanskrit ajras	'field'
ager	ajras	# Latin ager:Sanskrit ajras	'field'
#bʰarāmi	pʰerō	# Sanskrit bhārami:Greek pherō	'I carry'
bharāmi	pherō	# Sanskrit bhārami:Greek pherō	'I carry'
kentum	hekaton	# Latin centum:Greek hekaton	'100'
kentum	satəm	# Latin centum:Avestan satəm	'100'
